Path	Symbol	Reason
blue/dferris/jsalminen/GitHub/par_EEGProcessing/submodules/eeglab/plugins/dipfit/traditionaldipfit.m	sym	undeployable
blue/dferris/jsalminen/GitHub/par_EEGProcessing/submodules/fieldtrip/@config/private/compile_config.m	mex	undeployable
blue/dferris/jsalminen/GitHub/par_EEGProcessing/submodules/fieldtrip/@config/private/deepcopy.m	mex	undeployable
blue/dferris/jsalminen/GitHub/par_EEGProcessing/submodules/fieldtrip/@config/private/increment.m	mex	undeployable
blue/dferris/jsalminen/GitHub/par_EEGProcessing/submodules/fieldtrip/@config/private/setzero.m	mex	undeployable
blue/dferris/jsalminen/GitHub/par_EEGProcessing/submodules/fieldtrip/fileio/private/ft_scalingfactor.m	newunit	undeployable
blue/dferris/jsalminen/GitHub/par_EEGProcessing/submodules/fieldtrip/fileio/private/read_ctf_shm.m	mex	undeployable
blue/dferris/jsalminen/GitHub/par_EEGProcessing/submodules/fieldtrip/fileio/private/rotate.m	syms	undeployable
blue/dferris/jsalminen/GitHub/par_EEGProcessing/submodules/fieldtrip/fileio/private/solid_angle.m	mex	undeployable
blue/dferris/jsalminen/GitHub/par_EEGProcessing/submodules/fieldtrip/fileio/private/write_ctf_shm.m	mex	undeployable
blue/dferris/jsalminen/GitHub/par_EEGProcessing/submodules/fieldtrip/forward/private/ft_scalingfactor.m	newunit	undeployable
blue/dferris/jsalminen/GitHub/par_EEGProcessing/submodules/fieldtrip/forward/private/lmoutr.m	mex	undeployable
blue/dferris/jsalminen/GitHub/par_EEGProcessing/submodules/fieldtrip/forward/private/solid_angle.m	mex	undeployable
blue/dferris/jsalminen/GitHub/par_EEGProcessing/submodules/fieldtrip/inverse/private/ft_scalingfactor.m	newunit	undeployable
blue/dferris/jsalminen/GitHub/par_EEGProcessing/submodules/fieldtrip/inverse/private/rotate.m	syms	undeployable
blue/dferris/jsalminen/GitHub/par_EEGProcessing/submodules/fieldtrip/inverse/private/solid_angle.m	mex	undeployable
blue/dferris/jsalminen/GitHub/par_EEGProcessing/submodules/fieldtrip/plotting/private/ft_scalingfactor.m	newunit	undeployable
blue/dferris/jsalminen/GitHub/par_EEGProcessing/submodules/fieldtrip/plotting/private/ltrisect.m	mex	undeployable
blue/dferris/jsalminen/GitHub/par_EEGProcessing/submodules/fieldtrip/plotting/private/rotate.m	syms	undeployable
blue/dferris/jsalminen/GitHub/par_EEGProcessing/submodules/fieldtrip/plotting/private/solid_angle.m	mex	undeployable
blue/dferris/jsalminen/GitHub/par_EEGProcessing/submodules/fieldtrip/private/lmoutr.m	mex	undeployable
blue/dferris/jsalminen/GitHub/par_EEGProcessing/submodules/fieldtrip/private/rotate.m	syms	undeployable
blue/dferris/jsalminen/GitHub/par_EEGProcessing/submodules/fieldtrip/private/routlm.m	mex	undeployable
blue/dferris/jsalminen/GitHub/par_EEGProcessing/submodules/fieldtrip/private/solid_angle.m	mex	undeployable
blue/dferris/jsalminen/GitHub/par_EEGProcessing/submodules/fieldtrip/utilities/ft_scalingfactor.m	newunit	undeployable
blue/dferris/jsalminen/GitHub/par_EEGProcessing/submodules/fieldtrip/utilities/private/lmoutr.m	mex	undeployable
blue/dferris/jsalminen/GitHub/par_EEGProcessing/submodules/fieldtrip/utilities/private/rotate.m	syms	undeployable
